word	first_letter
babserts	b
badfle	b
badret	b
baltore	b
banction	b
bavil	b
bebime	b
beceld	b
becert	b
bedil	b
beheck	b
behere	b
bejint	b
bejips	b
bejird	b
bejire	b
bejite	b
belil	b
bemil	b
bengel	b
bertle	b
besame	b
besil	b
besime	b
betil	b
bewil	b
biek	b
bimybra	b
bimycra	b
biwilo	b
biwito	b
bizilu	b
bizitu	b
blick	b
boak	b
bobis	b
bocel	b
bogos	b
bood	b
booh	b
bovis	b
buma	b
bumpet	b
buncet	b
buntet	b
burtet	b
busset	b
buvil	b
cablarently	c
cabro	c
cagla	c
cairbort	c
canwraction	c
caricotate	c
casca	c
cass	c
cath	c
cawn	c
cedcus	c
cefscel	c
cemicic	c
cemplel	c
censtel	c
cesivic	c
cetigic	c
cetter	c
cewcus	c
ciapture	c
cibgre	c
cibsle	c
ciffre	c
circombany	c
cirticity	c
citequate	c
citerate	c
civigence	c
cobdience	c
cocoloy	c
coltansion	c
colternal	c
corolot	c
corolum	c
cosquation	c
cossical	c
cottusion	c
covigent	c
cufficiel	c
cumaiing	c
cunfective	c
cungrom	c
cusalyst	c
cusonion	c
custer	c
cutended	c
cutgument	c
cuvement	c
dablish	d
dade	d
dagid	d
dait	d
dake	d
dalder	d
dalt	d
danstant	d
dara	d
dartle	d
darto	d
dasel	d
dass	d
dasser	d
deast	d
defrore	d
dempa	d
derhin	d
derwin	d
desa	d
destread	d
dethere	d
diaptain	d
dichre	d
dinking	d
dirgle	d
dirlo	d
dirpa	d
distave	d
distre	d
ditfle	d
ditste	d
dockus	d
dorjin	d
dostade	d
dotter	d
dozzle	d
droca	d
drola	d
duch	d
duddle	d
dume	d
dund	d
dunsion	d
dunty	d
durway	d
dush	d
duss	d
facket	f
fagle	f
fany	f
fartory	f
fasy	f
fawerty	f
fawick	f
faxel	f
feams	f
feant	f
feckne	f
feckte	f
fehal	f
fengy	f
fessy	f
fethy	f
fewon	f
fexon	f
fexple	f
figgle	f
firceet	f
firplash	f
fiscocy	f
fiscofy	f
fiscomy	f
fissocy	f
fissofy	f
fixerry	f
foast	f
fobinat	f
fobitot	f
fokerty	f
fottle	f
fowitat	f
fuggard	f
fuggle	f
furare	f
furdwise	f
furgoil	f
furmoth	f
furoid	f
furpoin	f
fushle	f
fustays	f
fustle	f
fustoft	f
futgack	f
futote	f
gallow	g
ganter	g
garbant	g
garmack	g
garrard	g
garrete	g
gartiere	g
gedlet	g
gellow	g
gemen	g
gemlet	g
geslet	g
gester	g
gestops	g
getty	g
gibble	g
giceons	g
giddle	g
gidlet	g
gifrag	g
gigflet	g
gillel	g
gimen	g
gipple	g
girkard	g
girten	g
gizzick	g
gollow	g
gopen	g
gosen	g
gubber	g
guchers	g
gudgen	g
guffen	g
guglers	g
guglet	g
gugrers	g
guller	g
gumper	g
gunten	g
guplet	g
gurtheast	g
guslers	g
guslet	g
guspen	g
gussen	g
gutber	g
gutlers	g
hadber	h
halder	h
harthmust	h
hasser	h
hawerty	h
hecket	h
heffs	h
heggle	h
helts	h
hemes	h
hench	h
hencory	h
henge	h
herks	h
hertech	h
herts	h
herty	h
heths	h
hichnique	h
hikand	h
hizand	h
hizock	h
hocal	h
hoffs	h
hommer	h
hommy	h
hompy	h
hopmer	h
horal	h
horber	h
horder	h
horner	h
hoscy	h
hossy	h
howinat	h
howitot	h
howmer	h
howty	h
hubple	h
hucket	h
hudby	h
huffer	h
hufste	h
huggle	h
hulby	h
hulker	h
huller	h
hulper	h
janat	j
janbre	j
janfle	j
janhon	j
janmon	j
jarbish	j
jarsish	j
jarture	j
jarwish	j
jashel	j
jaskin	j
jeckem	j
jelume	j
jendar	j
jendir	j
jentor	j
jeytul	j
jiddle	j
jidewank	j
jilor	j
jimpo	j
jipkin	j
jisaks	j
jisays	j
jisbiss	j
jitkin	j
jixel	j
jockel	j
jodlish	j
jofage	j
jompo	j
jostike	j
jostime	j
jowkin	j
joxtul	j
jozage	j
juckep	j
juda	j
jueful	j
juegle	j
juggre	j
jukel	j
julfure	j
juli	j
jultude	j
jultums	j
jultuse	j
jultute	j
kabof	k
kabog	k
kack	k
kacolity	k
kantihy	k
kantoprater	k
kapif	k
kappics	k
kascing	k
kasog	k
kasy	k
katchum	k
katchuy	k
kecated	k
kectigess	k
kelney	k
kemney	k
kenat	k
kenter	k
kernation	k
kesney	k
kewney	k
kexney	k
kicanic	k
kidanic	k
kidition	k
kidmay	k
kightmase	k
kilnem	k
kinat	k
kipanic	k
kirifible	k
kirnem	k
kisclase	k
kisonic	k
koca	k
komble	k
kontinal	k
kovowls	k
kubi	k
kubo	k
kudu	k
kugu	k
kuju	k
kunat	k
kuncegation	k
kuppill	k
kuscouled	k
lacket	l
lagle	l
lakerry	l
laspuse	l
latle	l
leatore	l
leatude	l
leatums	l
leatute	l
lelily	l
lemby	l
lenter	l
lepple	l
lertle	l
lether	l
letple	l
lexprephrinary	l
lickel	l
liffer	l
liggle	l
ligups	l
lilily	l
lincer	l
lipple	l
lisoose	l
lobsench	l
lockle	l
loddy	l
loge	l
lolal	l
lold	l
lolily	l
loller	l
lomble	l
lommy	l
lort	l
loscy	l
lossy	l
louture	l
lubs	l
luce	l
luddage	l
lude	l
luller	l
lund	l
luss	l
lussice	l
luth	l
madbock	m
maddle	m
madlack	m
madpock	m
maldirl	m
malker	m
masegs	m
masill	m
massombs	m
mecker	m
medack	m
medble	m
medste	m
megate	m
melech	m
meleld	m
melept	m
melern	m
menate	m
mestirth	m
midpey	m
migcay	m
migray	m
milmy	m
mimble	m
miney	m
mistlic	m
mitular	m
mitzy	m
mivray	m
mobods	m
molind	m
molird	m
momble	m
mook	m
mosime	m
motulir	m
moxteen	m
mozzle	m
mufate	m
muggle	m
mugid	m
mulell	m
mulper	m
mulser	m
munact	m
murebs	m
mureft	m
nabber	n
nafurity	n
narerous	n
narire	n
narrone	n
nastrart	n
natchum	n
natode	n
natose	n
natote	n
nedlell	n
nedlews	n
nestump	n
netlell	n
netlern	n
netlert	n
nifes	n
nilking	n
nique	n
nirge	n
nisdalent	n
niths	n
nitreat	n
nitter	n
nittet	n
nived	n
nobed	n
nocklips	n
nolks	n
nolve	n
nopplil	n
nopstil	n
norbs	n
norls	n
nostlyl	n
novewed	n
noyment	n
nucklick	n
nucklips	n
nucklire	n
nuftril	n
nunereas	n
nuneries	n
nuneroos	n
nurger	n
nurtlet	n
nustrict	n
nutchuy	n
pachinding	p
padma	p
paked	p
pample	p
pands	p
panforiation	p
papes	p
paptock	p
parvation	p
paspock	p
pasts	p
pedger	p
pelessoally	p
pemble	p
pemstratum	p
pendy	p
penetny	p
pengy	p
penufeal	p
pescration	p
pesty	p
petlish	p
piforiate	p
piglish	p
pildlight	p
pimes	p
pince	p
pirks	p
pisergary	p
pohurity	p
ponancy	p
ponelfy	p
ponelry	p
pook	p
porwition	p
potick	p
potire	p
powarity	p
pudche	p
pudcle	p
pudphe	p
pudswe	p
pully	p
pultibra	p
pulticra	p
punky	p
punvidy	p
puptipla	p
qacy	q
qagy	q
qapy	q
qasy	q
quape	q
quawn	q
queck	q
quice	q
quift	q
quigs	q
quimb	q
quird	q
quirt	q
quith	q
quitre	q
quiys	q
quotore	q
qutithe	q
quxation	q
radbal	r
raddle	r
radwal	r
raltal	r
ranbre	r
ranium	r
ranken	r
ransight	r
rarning	r
rarute	r
rashus	r
rasute	r
rebutir	r
rebutor	r
recet	r
refet	r
retutir	r
retutor	r
rewet	r
reyet	r
rirning	r
ritfle	r
ritgre	r
ritste	r
rittle	r
rittre	r
robid	r
roctile	r
rodat	r
rodate	r
roddle	r
ronstead	r
ropate	r
rosat	r
rosol	r
rubid	r
rucid	r
ructige	r
ructill	r
rudble	r
rudger	r
runble	r
runter	r
rurgle	r
rurning	r
rutble	r
rutple	r
ruttle	r
sacaining	s
sachen	s
saciug	s
sacular	s
saggicrum	s
sallen	s
sancration	s
sapulir	s
sarund	s
saruse	s
sarush	s
sastairs	s
satvious	s
secepting	s
seddle	s
sedorrous	s
sembrall	s
semplment	s
senfowls	s
senter	s
sephasize	s
septimate	s
sesinfy	s
setcify	s
sextrume	s
sicersobility	s
siddle	s
silieve	s
simbress	s
simment	s
simprimpment	s
sincroding	s
siscre	s
sistment	s
sivanct	s
sobut	s
soca	s
soddle	s
sogut	s
somble	s
sonfranation	s
soostern	s
sosher	s
sotwoor	s
sula	s
sulpority	s
suncertorn	s
surnings	s
tacquess	t
tactord	t
tahoca	t
tammociate	t
tamy	t
tanfish	t
tanterpief	t
tantifely	t
tanvish	t
tapher	t
tascer	t
tasher	t
tathidding	t
tawabrieve	t
tecritional	t
tedal	t
tefal	t
tegamic	t
tegul	t
tehoto	t
tempitrous	t
teromic	t
tesacution	t
tewon	t
tibiniar	t
ticamy	t
tilily	t
timserb	t
tistence	t
toccalding	t
tomble	t
tomengous	t
tomon	t
tonger	t
toskection	t
tossible	t
tuctation	t
tuessy	t
tuggard	t
tulcty	t
tumerage	t
tunchy	t
tungy	t
tunker	t
tupocually	t
turghy	t
turter	t
tussy	t
tutilals	t
vackel	v
vambo	v
vanake	v
vancer	v
vanfish	v
vanrish	v
vapple	v
vapticra	v
vaxple	v
velleen	v
vename	v
vennir	v
vergike	v
vergill	v
vergle	v
versuct	v
vervill	v
vessian	v
vilste	v
vimbo	v
vinade	v
vinalls	v
vinkean	v
vinkeen	v
vipor	v
vittple	v
vocays	v
vockem	v
vondir	v
vople	v
voptibra	v
vormer	v
vosuce	v
vosuke	v
vosule	v
vosurn	v
vosurt	v
vowor	v
vozays	v
vudnar	v
vulhor	v
vupance	v
vupdar	v
vurthern	v
vustalls	v
vusume	v
vutnar	v
wacher	w
wadger	w
walder	w
waller	w
wamdus	w
wamper	w
wanler	w
wanment	w
warker	w
warmant	w
warter	w
watdus	w
wedfere	w
wedfore	w
wedhome	w
weggle	w
welcere	w
welen	w
welrere	w
wemcort	w
wemdome	w
wemfore	w
werlep	w
werlew	w
werney	w
wesen	w
wessure	w
westore	w
westuse	w
whick	w
wifter	w
wimper	w
wincer	w
winder	w
wirder	w
wisler	w
wisser	w
woins	w
wolks	w
wollet	w
woncing	w
worge	w
worlew	w
worns	w
wotter	w
wotty	w
yadonson	y
yappow	y
ybed	y
ybes	y
yed	y
yemns	y
yemts	y
ymecee	y
ymedee	y
ymefee	y
ymes	y
ympdee	y
ympfee	y
ymph	y
ymptow	y
yorit	y
yprit	y
ypts	y
yreree	y
yretow	y
yrrh	y
ythe	y
ythm	y
ythpow	y
yths	y
zabbie	z
zaller	z
zangion	z
zankion	z
zartion	z
zassion	z
zathion	z
zawblini	z
zaxplini	z
zefter	z
zeller	z
zelter	z
zembea	z
zemboe	z
zembou	z
zender	z
zendion	z
zeplo	z
zertle	z
zession	z
zetho	z
zettre	z
zilelin	z
zimblin	z
zinonic	z
zinslin	z
zinter	z
ziptlin	z
zirplin	z
zisand	z
ziwu	z
zobbee	z
zodo	z
zola	z
zoller	z
zopo	z
zors	z
zosh	z
zoso	z
zossion	z
zost	z
zove	z